##############################################################################
# The Hall of Blades
#
# This file is here for save compatibility reasons, and should be removed when
# TAG_MAJOR_VERSION >= 35. (i.e, it is only necessary if the TAG_MAJOR_VERSION
# is 34)
##############################################################################
: crawl_require('dlua/vault.lua')

{{
function blade_portal(e)
  local timeout_turns = crawl.random_range(2500, 3000)

  local messager =
    timed_msg {
      initmsg = { "You hear the distant clashing of blades...",
                  "Hark! There is a gateway to the Hall of Blades on this level. " ..
                  "Find the entrance quickly before the gate is sealed!" },
      finalmsg = "With a final great crash, the noises cease.",
      verb = 'clashing',
      noisemaker = 'an army of dancing weapons',
      ranges = {
        { 5000, 'faint ' },  { 4000, '' }, { 2500, 'loud ' },
        { 1500, 'thunderous ' }, { 0, 'deafening ' }
      }
    }

  e.lua_marker('O',
    timed_marker {
      turns = timeout_turns,
      msg = messager,
      floor = 'expired_portal',
      single_timed = true})
end
}}

# Dummy Blade entry
NAME:   blade_entry_dummy
TAGS:   blade_entry transparent
ORIENT: float
KFEAT:  O = enter_hall_of_blades
: blade_portal(_G)
MAP
O
ENDMAP


# Main layout
NAME:    hall_of_blades
TAGS:    no_dump no_monster_gen
PLACE:   Blade
ORIENT:  encompass
: halls_of_blades_weapon(_G)
SHUFFLE: C{D[ / C{D[ / D{C[ / D[C{ / D{D[
SUBST:   C = c, D[ = ., E : c.., F : c.., c : cv
NSUBST:  { : 1:{ / *:., . : 6:0 / 6 = 0. / 6 = 0... / *:.
KITEM:   R = demonic rune of Zot
MAP
xxxxxxxxxxxxxxxxxxxxxxxxxxxxxxxxxxxxxxxxxxxxxxxxxxxxxxxxxxxxxxxxxxxxxx
xxxccccccccccccccccccccccccccccccccccccccccccccccccccccccccccccccccxxx
xxxcccc....cccc.cccc.cccc{cccc.F.cccc.F.cccc.cccc.cccc.cccc....ccccxxx
xxxccF......cc...cc...cc...cc....{cc.....cc...cc...cc...cc......Fccxxx
xxxcc............................................................ccxxx
xxxc......c..............c..................c..............c......cxxx
xxxc.....ccc............ccc................ccc............ccc.....cxxx
xxxcE...ccccc..........ccccc..............ccccc..........ccccc...Ecxxx
xxxcE...ccccc...........ccc................ccc...........ccccc...Ecxxx
xxxc....0ccc.............c..................c.............ccc0....cxxx
xxxcE....ccc..............................................ccc....Ecxxx
xxxcE.....c................................................c.....Ecxxx
xxxc.............................[DD..............................cxxx
xxxc.............CC..............DDDD..............CC.............cxxx
xxxcE1...0......CCCC.............DDDD.............CCCC......0..R2Ecxxx
xxxc.............CC..............DDDD..............CC.............cxxx
xxxc..............................DD..............................cxxx
xxxcE.....c................................................c.....Ecxxx
xxxcE....ccc..............................................ccc....Ecxxx
xxxc....0ccc.............c..................c.............ccc0....cxxx
xxxc....ccccc...........ccc................ccc...........ccccc....cxxx
xxxcE...ccccc..........ccccc..............ccccc..........ccccc...Ecxxx
xxxcE....ccc............ccc................ccc............ccc....Ecxxx
xxxc......c..............c..................c..............c......cxxx
xxxcc............................................................ccxxx
xxxccF......cc...cc...cc...cc.....cc.....cc...cc...cc...cc......Fccxxx
xxxcccc....cccc.cccc.cccc.cccc.F.cccc.F.cccc.cccc.cccc.cccc....ccccxxx
xxxcccccccccccccccccccccccccccccccccccccccccccccccccccccccccccccccxxxx
xxxxxxxxxxxxxxxxxxxxxxxxxxxxxxxxxxxxxxxxxxxxxxxxxxxxxxxxxxxxxxxxxxxxxx
ENDMAP
